############
#      X  O#
#P      ##########
#          #     #
#######    #######
#O   ##    #
#    ##    #
#   X      #
#          #
#  X   O # #
############
